***X***
*     *
*   1 *
*******



************                        ******
* 1    *****                        *   2*
*   FFFFF***                        * Y  *
F*    FWW  *                        ******
***W********
***F********
***F    2***
************
